S#####.##
....##.##
#..###.G#
#.####.##
...#....#
##...####